0005000000000000000000000000000000000000000000000
0000000000000000000000000000000000000000000000000
0000000000000000000000000000000000000000000000000
0000000001111111111111000000000000000000000000000
0000000000000000000000000000000000000000000000000
0000000000000000000000000000000000000000000000000
0000000000000000000000000000000000000000000000000
0000000000000100000000000000000000000000000000000
0000000000000100000000000000000000000000000000000
0000000000000100000000000000000000000000000000000
0000000000006100000000000000001000000000000000000
0000000000000000000003000000000000000000000000000
0000000000000000000100000000000000000000000000000
1111111211114111111111100000000111111111111111110
0000000000000100000200000000000000000000000000000
0000000000000100000200000000000000000000000000000
0000000000000122222200000000000000000000000000000
0000000000000000000000000000000000000000000000000
0000000000000000000000000000000000000000000000000
0000000000000000000000000000000000000000000000000
1111111111111100000011111111111100000000000000000
0000000000000000000000000000000000000000000000000
0000000000000000000000000000000000000000000000000
0000000000000000000000000000000000000000000000000
1000000000000000000000000000000000000000000000001
1100000000000000000000000000000000000000000000011
1110000000000000000000000000000000000000000000111