000000000000000000000000000001
00000000000006000000000000001
000000000000000000000000000000
000050000000000000000000000001
000000001111000000111000000001
000000000000000000000000000001
000000000000010000000000000001
000000000000101000000000000001
000000000000010000000000000001
111100000000000000000000000001
100000000000000000000000000001
111111100000000000000000000001
100000000000000000000000000001
100000000000000012211000000001
100000000000000000000000000001
100000000000000300020000000001
100000000000000000020000000001
100000000000000000020000000001
111111000000001111111111111111
000000000000000000000000000000
000000000000000000000000000000
000000000000000000000000000000